File Version,,,,,,,,,,,,,,,,,,,,,,,,,,,,,,,,,,,,,,,,,,,,,,,,,,,,,,,,,,,,,,,,,,,,
2,,,,,,,,,,,,,,,,,,,,,,,,,,,,,,,,,,,,,,,,,,,,,,,,,,,,,,,,,,,,,,,,,,,,
Map_data,,,,,,,,,,,,,,,,,,,,,,,,,,,,,,,,,,,,,,,,,,,,,,,,,,,,,,,,,,,,,,,,,,,,
23,,,,,,,,,,,,,,,,,,,,,,,,,,,,,,,,,,,,,,,,,,,,,,,,,,,,,,,,,,,,,,,,,,,,4
23,,,,,,,,,,,,,,,,,,,,,,,,,,,,,,,,,,,,,,,,,,,,,,,,,,,,,,,,,,,,,,,,,,,,4
23,,,,,,,,,,,,,,,,,,,,,,,,,,,,,,,,,,,,,,,,,,,,,,,,,,,,,,,,,,,,,,,,,,,,4
23,,,,,,,,,,,,,,,,,,,,,,,,,,,,,,,,,,,,,,,,,,,,,,,,,,,,,,,,,,,,,,,,,,,,4
23,,,,,,,,,,,,,,,,,,,,,,,,,,,,,,,,,,,,,,,,,,,,,,,,,,,,,,,,,,,,,,,,,,,,4
50,,,,,,,,,,,,,,,,,,,,,,,,,,,,,,,,,,,,,,,,,,,,,,,,,,,,,,,,,,,,,,,,,,,,4
50,,,,7,2,2,,,7,25,25,25,,7,2,,,25,,,,,,30,,,,7,25,,,2,,25,25,25,,,,,7,,,2,,,,25,,,,25,25,25,,,25,25,25,,,2,,,25,,,4
50,,,,7,,,2,,7,,,,,7,,30,,25,,,,,2,,2,,,7,,2,,2,,2,,,25,,,,7,,,2,,,25,,25,,,2,,,7,,2,,,2,,2,,,25,,,4
50,,,,7,,,2,,7,,,,,7,,2,,25,,,,,2,,2,,,7,,2,,2,,2,,,25,,,,7,,,2,,,25,,25,,,2,,,7,,2,,,2,,,2,,25,,,4
50,,,,7,,2,,,7,2,2,,,7,,,2,2,,,,,2,,2,,,7,,,2,2,,2,,,2,,,,7,2,2,2,,,25,,25,,,2,2,2,,,2,2,2,,,,,2,,,,4
50,,,,7,,,2,,7,,,,,7,,,2,2,,,,2,2,2,2,2,,7,,,2,2,,2,,,2,,,,7,,,2,,2,2,2,2,2,,2,,,7,,2,,,2,,,,2,,,,4
50,,,,7,,,2,,7,,,,,7,,,,2,,,,2,,,,2,,7,,,,2,,2,,,2,,,,7,,,2,,2,,,,2,,2,,,7,,2,,,2,,,2,,,,,4
50,,,,7,2,2,,,7,2,2,2,,7,,,,2,,,,2,,,,2,,7,,,,2,,2,2,2,,,,,7,,,2,,2,,,,2,,2,,,7,,2,,,2,,,2,,,,,4
50,,,,7,4,,,,,,,,,7,,,,4,,,,,,,,,,7,,,,4,,,,,,,,,7,,,4,,,,,,,,,,,7,,,,,,,,4,,,,,4
50,,,,7,4,,,,,,,,,7,,,,4,,,,,,,,,,7,,,,4,,,,,,,,,7,,,4,,,,,,,,,,,7,,,,,,,,4,,,,,4
50,,,,,4,,,,,,,,,7,,,,4,,,,,,,,,,7,,,,4,,,,,,,,,7,,,4,,,,,,,,,,,7,,,,,,,,4,,,,,4
50,,,,,4,,,,,,,,,7,,,,4,,,,,,,,,,7,,,,4,,,,,,,,,7,,,4,,,,,,,,,,,7,,,,,,,,4,,,,,4
50,,,,,4,,,,,,,,,7,,,,4,,,,,,,,,,7,,,,4,,,,,,,,,7,,,4,,,,,,,,,,,7,,,,,,,,4,,,,,4
50,,,,,4,,,,,,,,,7,,,,4,,,,,,,,,,7,,,,4,,,,,,,,,7,,,4,,,,,,,,,,,7,,,,,,,,4,,,,,4
50,,,,,4,,,,,,,,,7,,,,4,,,,,,,,,,7,,,,4,,,,,,,,,7,,,4,,,,,,,,,,,7,,,,,,,,4,,,,,4
50,,,,,4,,,,,,,,,7,,,,4,,,,,,,,,,7,,,,4,,,,,,,,,7,,,4,,,,,,,,,,,7,,,,,,,,4,,,,,4
50,1,,,,4,,,,,,,,,7,,,,4,,,,,,,,,,7,,,,4,,,,,,,,,7,,,4,,,,,,,,,,,7,,,,,,,,4,,,,60,4
2,2,33,33,30,2,30,2,30,2,2,16,16,16,16,16,16,2,2,30,2,2,2,2,30,2,2,2,2,2,2,30,2,2,16,16,16,16,2,30,2,2,30,2,16,16,16,16,30,2,2,30,2,2,2,30,2,16,16,16,16,2,30,16,16,2,2,2,2
